0,0,0,0,0,0,0,0,0,0,0,0,0,0,0,0,0,0,0,0,0,0,0
0,0,0,0,0,0,0,0,0,0,0,0,0,0,0,0,0,0,0,0,0,0,0
0,0,8,6,6,8,6,6,8,6,6,8,6,6,8,6,6,8,6,6,8,0,0
0,0,7,2,2,2,2,2,2,2,2,2,2,2,2,2,2,2,2,2,7,0,0
0,0,7,2,5,5,5,0,0,0,0,0,0,0,0,0,5,5,5,2,7,0,0
0,0,8,2,5,5,4,0,0,0,0,0,0,4,4,0,0,5,4,2,8,0,0
0,0,7,2,4,4,0,0,0,4,4,0,0,0,4,0,0,4,4,2,7,0,0
0,0,7,2,4,0,0,0,4,5,5,0,0,0,5,5,0,0,5,2,7,0,0
0,0,8,2,0,0,0,4,5,8,5,4,0,0,5,4,4,0,0,2,8,0,0
0,0,0,2,0,0,0,4,5,7,4,0,0,0,4,4,0,0,0,2,0,0,0
0,0,0,2,0,0,0,0,0,7,0,0,0,4,0,0,4,4,0,2,0,0,0
0,0,8,2,0,0,0,0,0,8,0,5,5,4,0,0,4,5,0,2,8,0,0
0,0,7,2,5,0,0,0,0,7,0,4,5,4,0,0,0,0,0,2,7,0,0
0,0,7,2,4,0,0,0,0,7,0,0,0,0,0,0,9,0,0,2,7,0,0
0,0,8,2,4,4,0,0,0,8,0,0,0,0,0,0,0,0,0,2,8,0,0
0,0,7,2,4,4,0,0,4,7,0,0,0,0,0,0,0,0,0,2,7,0,0
0,0,7,2,2,2,2,0,5,7,4,4,4,2,2,2,2,2,2,2,7,0,0
0,0,8,6,6,8,2,0,5,8,5,5,4,2,8,6,6,8,6,6,8,0,0
0,0,7,2,2,2,2,0,4,7,5,4,5,2,2,2,2,2,2,2,7,0,0
0,0,7,2,0,0,0,0,4,7,0,0,0,0,0,0,0,0,0,2,7,0,0
0,0,8,2,0,0,9,0,0,8,0,0,0,0,0,0,0,4,4,2,8,0,0
0,0,7,2,0,0,0,0,0,7,0,0,3,0,0,0,4,4,5,2,7,0,0
0,0,7,2,4,0,0,0,0,7,4,4,0,0,0,4,5,4,5,2,7,0,0
0,0,8,2,5,5,4,0,0,8,5,4,0,0,0,0,5,4,0,2,8,0,0
0,0,7,2,5,4,0,0,4,5,5,4,0,0,0,0,0,0,4,2,7,0,0
0,0,7,2,4,0,0,0,0,4,4,4,0,0,0,0,0,0,0,2,7,0,0
0,0,8,2,0,0,0,0,0,0,0,0,0,8,6,6,8,0,0,2,8,0,0
0,0,0,2,0,0,0,4,4,4,4,0,0,0,0,0,0,0,0,2,7,0,0
0,0,0,2,0,0,0,4,5,5,4,0,0,0,0,0,0,0,0,2,7,0,0
0,0,8,2,0,0,0,4,5,8,0,0,0,0,0,0,0,4,4,2,8,0,0
0,0,7,2,0,0,0,0,4,7,0,0,0,0,9,0,0,5,4,2,7,0,0
0,0,7,2,0,0,0,0,0,7,0,0,0,0,0,0,0,0,0,2,7,0,0
0,0,8,2,0,0,0,0,0,8,0,0,0,0,0,0,4,0,0,2,8,0,0
0,0,7,2,4,0,0,0,0,0,0,0,5,5,4,4,5,4,4,2,7,0,0
0,0,7,2,5,4,0,0,0,0,0,0,5,4,4,5,5,4,0,2,7,0,0
0,0,8,2,5,4,0,0,0,0,4,4,0,0,4,4,5,0,0,2,8,0,0
0,0,7,2,5,5,4,0,0,0,0,4,0,0,0,0,0,0,0,2,7,0,0
0,0,7,2,2,2,2,2,2,2,2,2,2,2,2,2,2,2,2,2,7,0,0
0,0,8,6,6,8,6,6,8,6,6,8,0,0,8,6,6,8,6,6,8,0,0
0,0,0,0,0,0,0,0,0,0,0,0,0,0,0,0,0,0,0,0,0,0,0
0,0,0,0,0,0,0,0,0,0,0,0,0,0,0,0,0,0,0,0,0,0,0
